       %%%--        .
      %%%%---       .
     %%%%%----      .
    %%%%%%-----     .
   %%%%%%%------    .
  %%%%%%%%-------   .
 %%%%%%%%%--------  .
*********%--------- .
*********^......... .
 ********^........  .
  *******^.......   .
   ^^^^^^^......    .
    ^^^^^^.....     .
     ^^^^^....      .
       ^^^..        .
        ^^.         .
